F 205,100,12
C 20,30,14

EA ./img/xpm/east.xpm
SO ./img/xpm/south.xpm
WE ./img/xpm/west.xpm
NO ./img/xpm/north.xpm

111
   111   1
1111101111101111
1010000000000001
1010000100000111
10100000N0010001
1000000000010001
1111111111110111
           111

    111
    111    1
1111101111101111
1010000000000001
1010000100000111
10100000N0010001
1000000000010001
1111111111110111
           111

111
   111   1
1111101111101111
1010N00000000001
1010000100000111
1010000010010001
1000000100010001
1111111101110111
           111


111111111111111111111
100000000000000000001
111111111111111111101
100000000000000000101
101111111111111111101
101000000000000000101
101011111111111111101
101010000000000000101
101010111111111111101
101010000000000000101
101010001111111111101
101010001000N00000101
101010001011111111101
101010001010000000101
101010001010111111101
101010001010100000101
101010001010101111101
101010001010101000101
101010001010101011101
101010001010101010101
101010001010101010101
101010001010101010101
101010001010101010101
101010001010101010101
101010001010101010101
101010001010101010101
101010001010101010101
111111111111111111111
10001
100001
11111111111111111111


1111111111111111111111111111111111
1000000000000000000000000000000001
1111111111111111111111111111111111
1000000000000000000000000000000001
101111111111111111111N111111111101
1010000000000000000000000000000101
1010111111111111111111111111111101
1010100000000000000000000000000101
1010101111111111111111111111111101
1010100000000000000000000000000101
1010100011111111111111111111111101
1010100010000000000000000000000101
1010100010111111111111111111111111
1000000000000111100000000000000001
1111111111111111111100000000000111
1110000000000000111111111111111111
1111111111111111111111111111111111