F 205,100,12
C 20,30,14

EA ./img/xpm/east.xpm
SO ./img/xpm/south.xpm
WE ./img/xpm/west.xpm
NO ./img/xpm/north.xpm

    111
    11111111111111111                     
111110000000000000001
10000000000N000000001
111111111111011111111
 111       111                      
