F 205,100,12
C 20,30,14

EA ./img/xpm/east.xpm
SO ./img/xpm/south.xpm
WE ./img/xpm/west.xpm
NO ./img/xpm/north.xpm

111111111111111111111
100000000000000000001
100000000000000000001
10000000000000000000111
10000000N000000000001
100000000000000000001
111111111111000000111
           1111111111
