F 205,100,12
C 20,30,14

EA ./img/xpm/east.xpm
SO ./img/xpm/south.xpm
WE ./img/xpm/west.xpm
NO ./img/xpm/north.xpm


    111
    111111111111
1111101111101111
1010000000000001
1010000100000111
10100000N0010001
1000000000010001
1111111111110111
           111  