F 205,100,12
C 20,30,14

EA ./img/xpm/east.xpm
SO ./img/xpm/south.xpm
WE ./img/xpm/west.xpm
NO ./img/xpm/north.xpm

                     
1111111111111111111111
100000000000000011111
100000000000000000111
1000000000000E0000001
100000000000000000001
100000000000000000001                                
100000000000000000001
100000000000000000001
100000000000000000001
100000000000000000001
111111111111111111111                      