

F 200,100,125
C 220,30,0

EA ./img/xpm/east.xpm
SO ./img/xpm/south.xpm
WE ./img/xpm/west.xpm
NO ./img/xpm/north.xpm

1111111111111111
1010000000000001
1010000100000111
10100000NO0010001
1000000000010001
1111111111111111