F 205,100,12
C 20,30,14

SO ./img/xpm/south.xpm
EA ./img/xpm/east.xpm
WE ./img/xpm/west.xpm
NO ./img/xpm/north.xpm


1111111111111111
1010000000000001
1010000100000111
10100000S0010001
1000000000010001
1111111111111111
