F 205,100,12
C 20,30,14

SO ./img/xpm/south.xpm
EA ./img/xpm/east.xpm
WE ./img/xpm/west.xpm
NO ./img/xpm/north.xpm

 111111
11000001
100100001
10000N001
100000001
100000011
110000011
110000011
110000011
110000011
110000011
110000011
110000011
110000011
110000011
110000011
110000011
110000011
110000011
110000011
  11111
