SO ./img/xpm/south.xpm
EA ./img/xpm/east.xpm
WE ./img/xpm/west.xpm
NO ./img/xpm/north.xpm

F 220,100,0,d
C 225,30,0

1111111111111111
1010000000000001
1010000100000111
10100000N0010001
1000000000010001
1111111111111111
