SO ./img/xpm/south.xpm
EA ./img/xpm/east.xpm
WE ./img/xpm/west.xpm
NO ./img/xpm/north.xpm

F 220,100,0
C 225,30,0

 11111111111111111111111111
 11111100111111111100111111
 11110001111100111110001111
 11000001111000011110000011
 10000000111000011100000001
 10000000000000000000000001
10000000000000S0000000000001
1000000000BATMAN000000000001
 10000000000000000000000001
 10000110001000010001100001
 11001111111100111111110011
 11100111111100111111100111
 11111111111111111111111111
